W W W W W W W W W W W W W W W W W W W
W S S S S S S S S S S S S S S S S S W
W B W W S W W W W W W W W W S W W B W
W S S S S S S S S S S S S S S S S S W
W S W W S W S W W W W W S W S W W S W
W S S S S W S S S W S S S W S S S S W
W W W W S W W W E W E W W W S W W W W
E E E W S W E E E J E E E W S W E E E
W W W W S W E W E T E W E W S W W W W
E E E E S E E W R E L W E E S E E E E
W W W W S W E W W W W W E W S W W W W
E E E W S W E E E E E E E W S W E E E
W W W W S W E W W W W W E W S W W W W
W S S S S S S S S S S S S S S S S S W
W B W W S W W W W W W W W W S W W B W
W S S W S S S S S P S S S S S W S S W
W W S W S W S W W W W W S W S W S W W
W S S S S W S S S W S S S W S S S S W
W S W W W W W W S W S W W W W W W S W
W S S S S S S S S S S S S S S S S S W
W W W W W W W W W W W W W W W W W W W
